sWeaponTypeTwoHandRifleEnergy	Energy Rifle
sPlural	(s)
sResolution	Resolution
sInventoryCaps	Caps
sActiveMineDescription	Live
sKBWebSearch	Search
sPlayAudio	Play Audio
sInventoryQuantity	QTY
sMagicCastWhenStrikes	Weapon
sSelfRange	Self
sMale	Male
sHandToHandIcon	Icons\Weapons\HandToHand.dds
sKBA	A
sDeleteSuccessful	Save game deleted.
sOverEncumbered	You are overencumbered and cannot run!
sRSMEyeSockets	Eye Sockets
sCheekbonesthin	Cheekbones thin/wide
sRadsPerSecond	RAD/SEC
sComputersBack	Back
sTerminalLocked	You cannot hack this computer.
sKBB	B
sVoiceVolume	Voice
sKBC	C
sMenuDisplayQuicksaveName	Quicksave
sRadioWaveformFileFormat	Interface\Radio Wave\%s.dds
sMonthDecember	December
sHeadDamagedIcon	TypeIcons\hot_keys_icon_unarmedweapons.dds
sKBD	D
sLightFade	Light Fade
sChinsmall	Chin small/large
sKBE	E
sAnimationCanNotEquipArmor	You cannot change armor while attacking.
sKBF	F
sQuicksaveAbbrev	QUICK
sHours	hours
sKBG	G
sIngredientFail	 Ingredient had no effect.
sRestartBecauseContentRemoved	The game must restart now because downloaded content has been removed.
sStatsNoEffects	NO STATUS EFFECTS
sRemoveMarker	Remove It
sMagicEffectItemSecondsPlural	secs
sMagicEffectItemPercent	%
sMagicEffectItemFor	for
sKBH	H
sPluralPlain	s
sKBI	I
sAddItemtoInventory	added
sKBJ	J
sBeard	Beard
sRequirementsText	Req
sPS3LThumbRight	the Left Stick Right
sKBK	K
sCancelBarter	Cancel transaction?
sYesToAllText	Yes to all
sKBL	L
sLoadFromMainMenu	Are you sure you want to load this game?
sSkintintpurple	Skin tint purple/yellow
sInventoryItems	ITEMS
sSneakHidden	[HIDDEN]
sKarmaMinorLostImage	Interface\Icons\PipboyImages_small\Karma icons\glow_karma_bad.dds
sFullHealth	You are already at full health.
sKBM	M
sConfirmWarning	WARNING:  Any unsaved progress will be lost.
sHowManyWait	How long would you like to
sMouthlipsdeflated	Mouth lips deflated/inflated
sMagicCastOnce	(unused)
sKBN	N
sMiscPlayerDeadLoadOption	Reload
sWorldMapTabText	World Map
sKBO	O
sFrenziedByPlayerMessage	Frenzied
sXBRThumbUp	the Right Stick Up
sKBP	P
sRadiationSick	You are now sick with
sEyebrowsuppert	Eyebrows upper dark/light
sKBQ	Q
sPS3LThumbUp	the Left Stick Up
sKBR	R
sKBTab	Tab
sKBS	S
sLockBroken	The lock has been broken.
sLevelAbbrev	Level
sHUDHealth	Hlth
sKBT	T
sAddedEffects	Added Effects
sRSMMisc	Misc
sHealth	Health
sKBU	U
sStatsAP	AP
sDisarmMine	Disarm Mine
sTargetTypeActivate	Activate
sPS3Circle	\general_button_b.dds\
sKBV	V
sContractedDisease	You have contracted
sReturn	Return
sPS3StartBtn	Start
sXBRThumbRight	the Right Stick Right
sKBW	W
sUActnAutomove	Auto Move
sSaveGameCorruptMenuMessage	The save game is corrupt and cannot be loaded.
sCanNotTrainHigher	This NPC cannot help you train any higher.
sJawwide	Jaw wide/thin
sKBX	X
sUActnCrouch	Sneak
sMusicVolume	Music
sSettings	Settings
sNoRepairHostileActorsNear	You cannot repair items when enemies are nearby.
sRemoveItemfromInventory	removed
sLockLevelNameEasy	Easy
sXBDPadDown	D-Pad Down
sKBY	Y
sOldDownloadsAvailable	View Available Content
sXBRThumbLeft	the Right Stick Left
sKBRMenu	R-Alt
sKBZ	Z
sStatsEFFAbbrev	EFF
sRSMConfirmRandomize	Randomize your head?
sFileNotFound	File does not exist
sSkinshade	Skin shade dark/light
sNotEnoughCaps	You don't have enough caps.
sDaySunday	Sunday
sDownloads	Downloads
sTargetTypeTalk	Talk
sKBRControl	R-Ctrl
sFastTravelNoTravelHealthDamage	You can't fast travel while taking health damage
sJawline	Jawline concave/convex
sMagicEffectItemSecondsSingular	sec
sOKText	OK
sComputersHeader1	ROBCO INDUSTRIES UNIFIED OPERATING SYSTEM
sEnterName	Enter character name.
sChinretracted	Chin retracted/jutting
sData	DATA
sHitPointsShort	HP
sComputersHeader2	COPYRIGHT 2075-2077 ROBCO INDUSTRIES
sFirstPersonSkeleton	Characters\_1stPerson\Skeleton.NIF
sMagicCastWhenUsed	(unused)
sCrimeTypeSteal	Steal
sLeftLegDamagedMessage	Your left leg is now crippled.
sGFWLive	LIVE
sMoveMarker	Move It
sMonthMay	May
sNoFastTravelCell	You cannot fast travel from this location.
sForeheadsmall	Forehead small/large
sInventoryAmmo	AMMO
sTargetTypeOpenDoor	Open
sInventoryApparel	Apparel
sKBLWin	LWin
sCantQuickLoad	You can't Quickload while the game is paused.
sQuestUpdatedText	Quest updated
sLockLevelNameImpossible	Requires Key
sKBSleep	Sleep
sRestartToUseProfileContent	In order to use the downloaded content associated with this profile, you will need to restart.
sSetMarkerQuestion	Do you want to set your marker?
sRSMRace	Race
sNoFastTravelCombat	You cannot fast travel during combat!
sMagicTypeEnchantment	Object Effect
sSaveOnWait	Save On Wait
sEyesocketsdark	Eye sockets dark/light
sChemsWithdrawal	You are suffering from %s withdrawal.
sInventoryMisc	Misc
sBroken	[Locked - Broken]
sMagicEffectItemLock	Lock
sRadiationIncrease	Your radiation level has increased
sInventoryAmmoTab	Ammo
sSneakDanger	[DANGER]
sInventoryArmorClass	Armor Class
sMiscPlayerDeadMessage	Reloading the most recent save game
sTo	to
sResetToDefaults	Reset your control mappings to their default settings?
sMagicEffectItemUpToLevel	up to level
sRemaining	remaining
sKBInsert	Insert
sSleep	sleep
sRSMToneOption01	Flushed
sKBDivide	Pad /
sNoTalkFleeing	is fleeing.
sRSMToneOption02	Light/Dark
sRadioStationDiscovered	%s signal found.
sRSMToneOption03	Cheeks Light/Dark
sCantQuickSave	You can't Quicksave while the game is paused.
sRSMToneOption04	Circle Light/Dark
sRSMToneOption05	Goatee Light/Dark
sSkillIncreased	skill increased
sMagicCostliestEffectSkillOf	 Skill of 
sKBLBracket	[
sRadiationNotSick	You no longer have radiation sickness
sSneakAttackCriticalStrike	Sneak Attack Critical on
sCriticalStrike	Critical Strike on
sRSMToneOption06	Moustache
sMouthLips	Mouth(Lips)
sMagicEffectItemRestore	Restore
sRSMToneOption07	Blush Light/Red
sGeneralSkin	General(Skin)
sNoviceSkillLevelText	You have a basic understanding of this skill.
sRSMToneOption08	Bruised/Bright
sTargetTypeOpen	Open
sPS3RThumbLeft	the Right Stick Left
sUActnRdyitem	Ready/Reload
sRSMToneOption09	Dark/Light
sContainerItemsTitle	Inventory
sTransact	Transact
sMissingName	<Missing Name>
sUnequipItemOnPlayer	was unequipped
sIncrease	Increase
sVatsAimed	Aimed
sEmpty	[EMPTY]
sPCControlsTextPrefix	push
sRumble	Vibration
sSkillDecreased	skill decreased
sKarmicTitleNeutral01	Vault Dweller
sPressControl	Press the new control for this action
sKarmicTitleNeutral02	Vault Renegade
sEyeshadow	Eyeshadow light/dark
sKarmicTitleNeutral03	Seeker
sRSMEyelids	Eyelids
sScrollEquipped	 equipped.
sTerminalServerText1	-Server 1-
sKarmicTitleNeutral04	Wanderer
sTargetTypeSit	Sit
sKBMute	Mute
sNasolabiallines	Naso labial lines light/dark
sLevelUpSkillCounter	ASSIGN 1 SKILL POINT
sTerminalServerText2	-Server 2-
sKarmicTitleNeutral05	Citizen
sJoyDownLeft	Dn-Left
sMagicTypePoison	Poison
sTerminalServerText3	-Server 3-
sKarmicTitleNeutral06	Adventurer
sActivationChoiceMessage	What would you like to do?
sMiscUnknownEffect	(Unknown Effect)
sSaveFailed	Save failed.
sNotEnoughRoomWarning	You do not have enough room to drop this object.
sRepairAllItems	Repair All (%d)
sTerminalServerText4	-Server 4-
sKarmicTitleNeutral07	Vagabond of the Wastes
sMagicCastOKText	
sTerminalServerText5	-Server 5-
sKarmicTitleNeutral08	Mercenary
sRetryText	Retry
sWeaponTypeTwoHandAutomatic	Automatic
sCantHotkeyBrokenItem	You cannot hotkey broken items.
sRagdollDataDefault	RagdollConstraint\Default.rdt
sTerminalServerText6	-Server 6-
sKarmicTitleNeutral09	Urban Ranger
sObjectLODFade	Object LOD Fade
sNosebridgeshort	Nose bridge short/long
sSexFemalePronoun	she
sTerminalServerText7	-Server 7-
sActionPointsDrop	Drop
sKBRBracket	]
sSaveGameCorrupt	Corrupt
sTerminalServerText8	-Server 8-
sRightArmDamagedIcon	TypeIcons\hot_keys_icon_unarmedweapons.dds
sPS3Square	\general_button_x.dds\
sMouthdrawn	Mouth drawn/pursed
sBuy	BUY
sTerminalServerText9	-Server 9-
sMustRestart	You must exit and restart Fallout 3 for changes in this setting to take effect.
sSexFemale	female
sHolidayEmperorsBirthday	Emperor's Birthday
sActionPointsHeal	Heal
sDeviceGamepad	Xbox 360 Controller
sNoMoreFollowers	You have too many followers.
sMiscConstantEffect	Constant Effect
sDeleteSaveGame	Are you sure you want to delete this save game?
sDropQuestItemWarning	You cannot remove Quest Items from your Inventory.
sImageNote	Image File
sLevelUp	LEVEL UP
sComputersAddedNote	Note Added: %s
sBald	Bald
sNoEatQuestItem	You can not eat quest items.
sRepairSkillTooLow	%d%s REPAIR SKILL NEEDED
sNoseshort	Nose short/long
sMouth	Mouth
sQuantity	Quantity
sBloodParticleDefault	Effects\ImpactBallisticBlood01.NIF
sMagicEffectItemCreateLock	Create
sHolidayOldLifeFestival	Old Life Festival
sLockLevelNameVeryEasy	Very Easy
sKBVolumeUp	Vol +
sLoading	Loading...
sLevelUpPerkCounterPl	CHOOSE %d PERKS
sKBHome	Home
sServeTimeQuestion	Do you just want to serve your time?
sJournalTitleCompleted	Completed Quests
sTravelQuestion	Do you want to travel to
sMissingImage	Data\Textures\Interface\Shared\missing_image.dds
sOff	OFF
sTargetRange	Target
sRSMToneOption10	Thick/Thin
sPS3Triangle	\general_button_y.dds\
sStartNewGame	Start new game?
sNoSleepTrespass	You cannot sleep while trespassing.
sRSMToneOption11	Very Thin/Thick
sXBLThumbDown	the Left Stick Down
sHowMany	How many?
sRSMToneOption12	Light/Dark (Lower)
sNose	Nose
sCurrentObjective	CURRENT OBJECTIVE
sYour	Your
sPCMenuHintA	A)
sDeviceRemoved	The save device you selected is no longer available.  You will need to select a new device the next time you save.  Until then, Autosave is disabled.
sRSMToneOption13	Light/Dark (Outer)
sNoseselliondown	Nose sellion down/up
sNoText	No
sRSMToneOption14	Dark/Light (Upper)
sNoRestart	No, keep playing.
sOutOfLockpicks	You are out of lockpicks.
sRSMToneOption15	Pale/Red
sInventoryWeapons	Weapons
sMagicCostliestEffectRequires	Requires 
sHolidayMidYearCelebration	Mid Year Celebration
sAlignNeutral	Neutral
sRSMToneOption16	Eyeliner Lt./Dark
sAlreadyPlacedMine	An active mine has already been placed on this enemy.
sPCMenuHintE	E)
sRSMToneOption17	Shadow Light/Dark
sActivateNPCCalmed	is calmed and cannot respond.
sMagicEffectItemOn	on
sPCMenuHintF	F)
sPCControlsTriggerPrefix	pull
sMenuDisplayAutosaveName	Autosave
sRSMToneOption18	Dk Brown/Lt Blue
sInventoryValue	VAL
sHigh	High
sRSMToneOption19	Whites Dim/Bright
sKBSysRq	PrntScrn
sDifficulty	Difficulty
sHotKeyString	Hot Key
sDownloadsAvailable	New Content Available
sKarmicTitleNeutral10	Observer
sXBBBtn	\general_button_b.dds\
sKarmicTitleNeutral11	Capitol Councilor
sKBWebRefresh	Refresh
sKBColon	:
sUActnForward	Forward
sDropEquippedItemWarning	You cannot drop an equipped item until you complete your current action.
sNosedown	Nose down/up
sLocalMapTabText	Local Map
sKarmicTitleNeutral12	Keeper
sEssentialCharacterDown	is unconscious.
sAmber	AMBER
sInventoryWeight	Wg
sSortMethod	Sort
sHolidaySecondPlanting	Second Planting
sKarmicTitleNeutral13	Vault Descendant
sJoyDownRight	Dn-Rt
sKBUp	Up
sVatsBodyPart	Body Part
sDefaultPlayerName	Player Name
sRSMConfirmDone	Are you sure you want this to be your
sImpactParticleWoodDefault	Effects\ImpactBallisticWood01.nif
sKarmicTitleNeutral14	Pinnacle of Survival
sKBEquals	=
sNumberAbbrev	No.
sKarmicTitleNeutral15	Urban Myth
sKarmicTitleNeutral16	Strider of the Wastes
sTravel	Travel
sKarmicTitleNeutral17	Beholder
sKarmicTitleNeutral18	Wasteland Watcher
sPCMenuHintR	R)
sNosenostriltilt	Nose nostril tilt down/up
sJaw	Jaw
sKarmicTitleNeutral19	Super-Human
sPCMenuHintS	S)
sSuccessfulSneakAttackMain	Sneak attack for 
sPleaseStandBy	PLEASE STAND BY
sTraitsTitle	OPTIONAL TRAITS:  %d/%d Selected
sDeviceMouse	Mouse
sRed	Red
sAge	Age
sAttributesTitle	ATTRIBUTES: %d/%d Points Assigned
sMagicSchoolMysticism	Mysticism
sDayThursday	Thursday
sTeammateOverencumbered	can't carry any more.
sPCMenuHintW	W)
sLipsflushed	Lips flushed/pale
sMouthChin	Mouth-Chin distance short/long
sEyesdown	Eyes down/up
sPCMenuHintX	X)
sBloodParticleMeleeDefault	Effects\ImpactMeleeBloodSpray01.nif
sFloraFailureMessage	You find nothing of use.
sHolidayJestersDay	Jester's Day
sKBPrior	PgUp
sAutoAttempt	Auto Attempt
sKarmaMajorLost	You've lost Karma!
sHackingDudRemoved	Dud removed.
sNoPickPocketAgain	has already caught you.
sWeaponBreak	Your weapon has broken.
sSwitchLimbs	Switch Limbs
sColor	Hair Color
sMagicRangeTouch	Touch
sMagicEffectItemAbsorb	Absorb
sMonthFebruary	February
sRightArmDamagedMessage	Your right arm is now crippled.
sMenuDisplayUnknownLocationString	Unknown Location
sMenuDisplayNoSaves	No saved games.
sControls	Controls
sRSMRedAbbrev	R:
sBeardgoatee	Beard goatee light/dark
sPlaceMarker	Place Marker
sDismemberParticleDefault	Gore\BloodSprayLimb01.nif
sCrimeTypePickpocket	Pickpocket
sCloseButton	Close
sEyebrowsdark	Eyebrows dark/light
sMapMarkerNotFound	You have not found this location yet.
sUActnTogglerun	Always Run
sRSMToneOption20	Dark Red/Lt. Blue
sRandom	Random
sMagicRangeSelf	Self
sChestDamagedIcon	Interface\Icons\Message Icons\glow_message_vaultboy_very_happy.dds
sStatsCrippled	CRIPPLED
sRSMToneOption21	Dark Blue/Lt. Red
sMagicSchoolIllusion	Illusion
sWeaponTypeTwoHandLauncher	Launcher
sKBWake	Wake
sXSensitivity	X-Sensitivity
sHUDOpacity	HUD Opacity
sNoWaitInAir	You cannot wait in the air.
sRSMToneOption22	Naso Labial Lines
sPS3LThumbDown	the Left Stick Down
sRSMToneOption23	Nares Small/Large
sDayFriday	Friday
sControllerOption	Turn off 360 Controller in the Controls section of the Settings menu to switch back to Keyboard/Mouse.
sGrassFade	Grass Fade
sRSMToneOption24	Shade
sConfirmChoice1	Are you sure you want to be a
sRSMToneOption25	Blue Tint
sEyelidslight	Eyelids light/dark
sConfirmChoice2	Are you sure you want to be an
sExit	Exit
sRSMToneOption26	Yellow Tint
sGold	gold
sCancel	Cancel
sMagicSchoolRestoration	Restoration
sMiscStat000	Quests Completed
sXBUnboundBtn	<NOT BOUND>
sNoWaitHostilActorsNear	You cannot wait when enemies are nearby.
sFacebrow	Face brow/nose/chin ratio
sMiscStat001	Locations Discovered
sAnimationCanNotEquipWeapon	You cannot change weapons while attacking.
sPMTime	PM
sSpecNameMagic	Magic
sMiscStat002	People Killed
sVATSMessageZeroChance	You have zero chance to hit.
sEyeliner	Eyeliner
sHackingDenied	Entry denied
sYes	Yes
sMiscStat003	Creatures Killed
sXBLThumbRight	the Left Stick Right
sJoyDown	Down
sFindingContentMessage	Looking for content.  Please wait.
sMiscStat004	Locks Picked
sLockLevelNameAverage	Average
sEffectAlreadyAdded	Effect has already been added.  Edit the effect instead.
sEyebrowsvery	Eyebrows very thin/thick
sSkillIncreasedNum	%s increased by %d
sMiscStat005	Computers Hacked
sKarmicTitleNeutral20	Paradigm of Humanity
sNoseregion	Nose region concave/convex
sInventoryHotKey	Hot Key
sKarmaMinorLost	You've lost Karma!
sMiscStat006	Stimpaks Taken
sActionPointsShoot	Shot
sTouchRange	Strike
sPoisonBowConfirmMessage	Do you want to poison your next shot with the 
sExplosive	EXPLOSIVE
sHolidayWitchesFestival	Witches' Festival
sMiscStat007	Rad-X Taken
sNoWaitTakingHealthDamage	You cannot wait while taking health damage.
sMiscStat008	RadAway Taken
sDeviceKeyboard	Keyboard
sMiscStat009	Chems Taken
sMagicTypeDisease	Disease
sDecrease	Decrease
sMedium	Medium
sMonthAugust	August
sUActnVats	VATS
sKeyring	Keyring
sPauseText	Pause
sBeardcheeks	Beard cheeks light/dark
sSaveGameNoMasterFilesFound	None of the master files used in this save game are loaded.  Returning to game.
sCheeksround	Cheeks round/gaunt
sBeardlight	Beard light/dark
sSeasonWinter	Winter
sJournalTitleCurrent	Current Quests
sDownloadsNotAvail	View Downloadable Content
sPS3Ecks	\general_button_a.dds\
sRace	Race
sNoRace	NO RACE
sCantEquipBrokenItem	Broken items cannot be equipped until they have been repaired.
sSpecularityFade	Specularity Fade
sRanksText	Ranks
sImpactParticleConcreteDefault	Effects\ImpactBallisticConcrete01.nif
sRandomDoorTeleportFailureMessage	This door leads nowhere.
sChestDamagedMessage	Your chest is now damaged.
sNoFastTravelOverencumbered	You cannot fast travel while overencumbered.
sChinshallow	Chin shallow/deep
sPS3R1	\general_button_rb.dds\
sLeftLegDamagedByPlayerIcon	Interface\Icons\Message Icons\glow_message_vaultboy_very_happy.dds
sPS3R2	\general_button_rt.dds\
sKBUnderline	_
sWhite	WHITE
sPS3R3	\general_button_rs.dds\
sCrimeTypeAttack	Attack
sXBDPadUp	D-Pad Up
sVampireFeed	Feed
sNoSpareParts	NO USABLE SPARE PARTS
sComputersLogon	LOGON ADMIN
sObjectFade	Object Fade
sKBSlash	/
sChangeItemSelection	Change Item Selection
sKBSubtract	Pad -
sHairColor10	Gold
sHolidayNewLifeFestival	New Life Festival
sPCControlsTextNone	<NOT BOUND>
sSaveGameNoLongerAvailable	The save game is no longer available.  Returning to game.
sHairColor11	Rosewood
sTargetTypeApply	Apply
sHairColor12	Black
sQuestAddedText	Quest added
sMagicSchoolDestruction	Destruction
sHairColor13	Chestnut
sMonthOctober	October
sPS3DPadUp	D-Pad Up
sKBEnd	End
sHairColor14	Steel
sEyebrowsthick	Eyebrows thick/thin
sMonthSeptember	September
sUActnTogglepov	Change View
sUActnActivate	Activate
sHairColor15	Champagne
sKBNumlock	Num
sConfirmDelete	Delete this game?
sDisplay	Display
sSelectItemToRepair	CHOOSE ITEM TO REPAIR WITH
sHolidayHarvestsEnd	Harvest's End
sMiscStat010	Times Addicted
sMiscPlayerDeadMenuOption	Main Menu
sLevelUpTitleText	WELCOME TO LEVEL %d
sHackingAccessing1	Please wait
sMiscStat011	Mines Disarmed
sPS3UnboundBtn	<NOT BOUND>
sHackingAccessing2	while system
sMiscStat012	Speech Successes
sContinueText	Continue Running Executable?
sUActnSldright	Strafe Right
sNewGame	New Game
sNoSleepInRadiation	You cannot sleep while being irradiated.
sInventoryWeightUpper	WG
sHackingAccessing3	is accessed.
sMiscStat013	Pockets Picked
sPicksRemainingText	Bobby Pins
sMiscStat014	Pants Exploded
sKBWebHome	Web
sStartANewGame	Start a New Game?
sLocked	Locked
sShadowFade	Shadow Fade
sMasterVolume	Master
sRSMCustomize	Customize
sMiscStat015	Books Read
sActionPointsPunch	Punch
sSearch	Search
sVATSMessageLowAP	Low
sBeardcircle	Beard circle light/dark
sMiscStat016	Bobbleheads Found
sMenuDisplayLevelString	Level
sLevelUpPerkCounter	CHOOSE 1 PERK
sMonthJanuary	January
sMiscStat017	Weapons Created
sMagicProjectileTypeBall	Ball
sMiscStat018	People Mezzed
sActionMapping	Action Mapping
sCantChangeResolution	You must close your current game to change resolutions.
sMiscStat019	Captives Rescued
sJoyRight	Right
sRSMShapeOption01	High/Low
sYSensitivity	Y-Sensitivity
sRSMShapeOption02	Up/Down (inner)
sNoSaves	[NO SAVES FOUND]
sRSMShapeOption03	Up/Down (outer)
sRSMShapeOption04	Low/High
sReset	Reset
sMenuDisplayNewSave	New Save
sStatsLimbs	Limbs
sRSMShapeOption05	Shallow/Pronounced
sMoveMarkerQuestion	Do you want to move your marker or remove it?
sRSMShapeOption06	Thin/Wide
sRSMShapeOption07	Concave/Convex
sRSMShapeOption08	Round/Gaunt
sGeneralFace	General(Face)
sNormalWeaponsResisted	Your attack has no effect.
sMagicEffectItemFeet	ft
sRSMShapeOption09	Forward/Backward
sEyebrowsouter	Eyebrows outer light/dark
sCommsTabText	Radio
sActionPointsSwitchWeapon	Switch Weapon
sHackingLockout1	Lockout in
sDefaultMessage	DEFAULT MESSAGE TEXT
sCantRemoveWornItem	Unable to remove the worn item.
sHackingLockout2	progress.
sUActnBlock	Block
sHackingLockout3	TERMINAL LOCKED
sSaveGameContentIsMissing	This save relies on content that is no longer present. Some objects may no longer be available. Continue Loading?
sHackingLockout4	PLEASE CONTACT AN ADMINISTRATOR
sDismemberRobotParticleDefault	Gore\RobotLimbSpray01.nif
sMagicCastInsufficientSkill	Your Skill level is too low
sRSMHair	Hair
sShowActiveNotes	Show Active Quest Notes
sPS3RThumbUp	the Right Stick Up
sAudioNote	Audio File
sMagicProjectileTypeBolt	Bolt
sMagicTypeSpell	Actor Effect
sCrew	Crew
sNew	New
sPrevious	Previous
sSmall	Small
sWeaponTypeOneHandMelee	Melee - One Hand
sStats	STATS
sMagicProjectileTypeFog	Fog
sHolidaySunsRest	Sun's Rest
sSaveOverSaveGame	Are you sure you want to overwrite this save game?
sCantUnequipGeneric	You cannot unequip this item.
sHUDQuestCompleted	COMPLETED: 
sQuestFailed	Quest FAILED
sMagicTypeAbility	Ability
sXBYBtn	\general_button_y.dds\
sCrosshair	Crosshair
sKBMediaSelect	Select
sMouthlipspuckered	Mouth lips puckered/retracted
sJournalTitleCompletedDetails	Completed Quest Detail
sWeaponTypeOneHandGrenade	Grenade
sXBDPadLeft	D-Pad Left
sPS3DPadDown	D-Pad Down
sKBWebFavorites	Fav
sMedicineSkill	Med skill
sItemFade	Item Fade
sLips	Lips
sBack	Back
sMiscStat020	Sandman Kills
sRepairCost	Cost: %d caps
sNoseTex	Nose shades
sMiscStat021	Paralyzing Punches
sAttributeDrained	is being drained
sAreaText	Area
sMiscStat022	Robots Disabled
sBrowRidge	Brow Ridge high/low
sNoSleepInOwnedBed	You cannot sleep in an owned bed.
sMiscStat023	Contracts Completed
sNoCharge	The item does not have enough charge.
sPoisonConfirmMessage	Do you want to poison the 
sMagicSchoolConjuration	Conjuration
sMiscStat024	Corpses Eaten
sMiscStat025	Mysterious Stranger Visits
sForeheadtilt	Forehead tilt forward/back
sTargetTypeEat	Eat
sXBRBumper	\general_button_rb.dds\
sNoFastTravelInAir	You can't fast travel while jumping or falling.
sRestartToUseNewContent	New content has been added.  You will need to restart to use this content.  All unsaved progress will be lost.
sFaceround	Face round/gaunt
sLeftArmDamagedByPlayerIcon	Interface\Icons\Message Icons\glow_message_vaultboy_very_happy.dds
sUActnSldleft	Strafe Left
sNosesellionshallow	Nose sellion shallow/deep
sKBABNTC1	/
sTreeLODFade	Tree LOD Fade
sDialogSubtitles	Dialog Subtitles
sLoad	Load
sRSMShapeOption10	Broad/Recessed
sMouthhappy	Mouth happy/sad
sKBABNTC2	Pad .
sNoRepairInCombat	You cannot repair items while in combat.
sRSMShapeOption11	Retracted/Jutting
sLength	Length
sDiscoveredText	You have discovered
sDevice	Device
sRepairServicesTitle	Repair Services
sRSMShapeOption12	Shallow/Deep
sPickpocketFail	You've been caught pickpocketing.
sXBLBumper	\general_button_lb.dds\
sQuickLoading	Quickloading...
sRSMShapeOption13	Small/Large
sRightLegDamagedIcon	TypeIcons\hot_keys_icon_unarmedweapons.dds
sRSMShapeOption14	Tall/Short
sActionPointsAttack	Attack
sRSMShapeOption15	Wide/Thin
sNext	Next
sDayWednesday	Wednesday
sRSMShapeOption16	Down/Up
sQuestCompletedText	Quest completed
sRestartSignedOut	You have signed out of your profile and will now be returned to the main menu.
sLoadWhilePlaying	Are you sure you want to load this game?  All unsaved progress will be lost.
sChoose	Choose
sLockpickSkillText	Lockpick Skill
sRSMShapeOption18	Tilt in/out
sTone	Tone
sMagicRangeTarget	Target
sCorruptContentMessage	Some of your downloaded content is corrupt and could not be loaded.
sRSMShapeOption19	Together/Apart
sEntryInstructions1	Enter a name for the
sInventoryName	NAME
sEntryInstructions2	you are trying to create.
sKBSpace	Spc
sEffectsVolume	Effects
sRSMGeneral	General
sLeaveMarker	Leave It
sShowAllNotes	Show All Notes
sMagicSchool	Magic School
sChestDamagedByPlayerIcon	Interface\Icons\Message Icons\glow_message_vaultboy_very_happy.dds
sKBRight	Right
sAutoSaving	Autosaving...
sNosenostrilssmall	Nose nostrils small/large
sNotesTabText	Notes
sSave	Save
sCantHotkeyItem	You cannot hotkey that item.
sRepair	REPAIR
sNoseflat	Nose flat/pointed
sInventoryAid	Aid
sAddItemtoSpellList	added
sFor	for
sSeasonSpring	Spring
sKBApostrophe	'
sNoChildUse	Children cannot use that.
sSuccessfulSneakAttackEnd	X damage!
sSkillsCount	Tag %d Skill
sKBNumPadEnter	Pad Enter
sGotAwayWithStealing	got away with stealing
sRaceDescription	Race Description
sNoProfileSelected	You have not signed in to a Gamer Profile.  You will need to sign in to a Gamer Profile and then select a storage device before you can save.  Until then, Autosave is disabled.
sCanNotEquipWornEnchantment	You cannot equip this item right now.
sMouthprotruding	Mouth protruding/retracted
sLipstickdarkred	Lipstick dark red/light blue
sCheeks	Cheeks
sUActnBack	Back
sPlayerLeavingBorderRegion	You cannot proceed in that direction. Please turn back.
sSpace	 
sChemsAddicted	You have become addicted to %s.
sNoWaitInCell	You cannot wait in this location.
sStopAudio	Stop Audio
sPartCrippledByPlayerMessage	Crippled
sKBTilde	~
sGameplay	Gameplay
sMagicEffectItemPointsSingular	pt
sKBMinus	-
sNewSave	[NEW SAVE]
sMouseMiddleButton	Wheel
sMouseSensitivity	Mouse Sensitivity
sJawNeck	Jaw-Neck slope high/low
sChinforward	Chin forward/backward
sMagicCastPowerUsed	You can only cast Powers once per day
sTargetTypeBrew	Brew
sAbortText	Abort
sCriticalStrikeIcon	Interface\Icons\PipboyImages_small\Derived Statistics_small\glow_Critical_Chance.dds
sStatsSkills	Skills
sRSMCharacter	character
sInvalidPickpocket	You cannot place items in a container while pickpocketing.
sCanNotReadBook	You cannot read a book during combat!
sGeneralSubtitles	General Subtitles
sActionPointsShort	AP
sMagicCastSilenced	You are currently Silenced
sKBSemicolon	;
sHUDColor	HUD Color
sRSMHairStyle	Hair Style
sMouthunderbite	Mouth underbite/overbite
sJawretracted	Jaw retracted/jutting
sNPCModelFemale	Characters\_Male\Skeleton.NIF
sSpeechChallengeSuccess	[SUCCESS]
sSkillLevelExpert	Expert
sPS3DPadX	D-Pad Left/Right
sKBDown	Down
sNoFastTravelUndiscovered	You have not discovered this location yet.
sVATSMessageNoAmmo	You don't have enough ammo.
sRSMShapeOption20	Brow-Nose-Chin
sPS3DPadY	D-Pad Up/Down
sVideoChange	You must exit and restart Fallout 3 for the new resolution to take effect.
sQuit	Quit
sRSMShapeOption21	Forehead-Nose
sTargetTypeHorse	Ride
sRSMShapeOption22	Heavy/Light
sMagicTypeLesserPower	Lesser Power
sRepairSkill	Repair Skill
sBrainDamagedByPlayerIcon	Interface\Icons\Message Icons\glow_message_vaultboy_very_happy.dds
sMouseLeftButton	Mouse1
sSaveGameOutOfDiskSpace	The selected storage device does not have sufficient space available. Please select another storage device or delete some of your existing saved content.
sStatsXPMax	MAX
sHackingGranted	Exact match!
sSell	SELL
sMorphine	Med-X
sRepairItem	Repair
sRSMShapeOption27	Tilt Forward/Back
sNares	Nares small/large
sTargetTypeCrown	Talk
sWeaponTypeTwoHandRifle	Rifle
sLeftLegDamagedIcon	TypeIcons\hot_keys_icon_unarmedweapons.dds
sChin	Chin
sActionPointsStand	Stand
sActionPointsToggleWeaponDrawn	Toggle Weapon Drawn
sTargetTypeRepair	Repair
sPS3RThumbX	the Right Stick Left / Right
sPS3RThumbY	the Right Stick Up / Down
sPS3SelectBtn	Select
sXBLTrigger	\general_button_lt.dds\
sKBAt	@
sKBNumPadEquals	Pad =
sKBLMenu	L-Alt
sFaceheavy	Face heavy/light
sKBPrevtrack	Prev
sMagicEffectResisted	effect resisted
sNPCModelMale	Characters\_Male\Skeleton.NIF
sKBPower	Power
sKBScroll	Scroll
sLockLevelText	Lock Level
sDone	Done
sPS3LThumbX	the Left Stick Left / Right
sXBLThumbLeft	the Left Stick Left
sXBABtn	\general_button_a.dds\
sUActnGrab	Grab
sLoadThisGame	Load this game?
sMagicCastConstant	Apparel
sPS3LThumbY	the Left Stick Up / Down
sFaceforehead	Face forehead/sellion/nose ratio
sKarmaMajorGained	You've gained Karma!
sMagicEffectItemPointsPlural	pts
sMonthApril	April
sRightLegDamagedMessage	Your right leg is now crippled.
sExitGameAffirm	Exit Game
sObjectInUse	This object is already in use by someone else.
sStatsHP	HP
sNo	No
sMakeActiveQuest	Make Active Quest
sDayTuesday	Tuesday
sStatsCondition	Condition
sMakeDefaults	Make these your default settings?
sXBLThumbUp	the Left Stick Up
sKnownEffects	Known Effects
sStatsEffects	Effects
sWeaponTypeHandToHandMelee	Melee - Hand to Hand
sKBWebForward	Web ->
sNoSleepTakingHealthDamage	You cannot sleep while taking health damage.
sJunk	Junk
sSeasonSummer	Summer
sDayMonday	Monday
sEyelidspale	Eyelids pale/red
sShowLocation	Show Location
sVampireFeedQuestion	What would you like to do with this innocent townsperson?
sRangeText	Range
sAlignVeryGood	Very Good
sEyebrowslower	Eyebrows lower light/dark
sSkin	Skin
sWeaponTypeOneHandMine	Mine
sUActnJump	Jump
sOpenWithKey	Unlocked with %s.
sChinpronounced	Chin pronounced/recessed
sXBStartBtn	START
sKBPause	Pause
sKBUnlabeled	Unlabeled
sWeaponTypeOneHandPistolEnergy	Energy Pistol
sXBRTrigger	\general_button_rt.dds\
sUActnMenumode	Pip-Boy
sSpeechChallengeFailure	[FAILED]
sKBCapital	Caps
sNoLockPick	You don't have any bobbypins.
sInventoryEquip	Equip
sSkillLevelMaster	Master
sNoWaitWhileAlarmSounding	You are unable to wait here. An alarm is sounding with your name on it.
sBrow	Brow
sMagicTypeWortcraft	Wortcraft
sXBRThumbDown	the Right Stick Down
sRSMShapeOption30	Slope High/Low
sGender	Gender
sArmorWeightHeavy	Heavy
sHackIneligible	A %s skill of %d is required to hack this terminal.
sKBPlayPause	Play
sRadiationDecrease	Your radiation level has decreased
sEyessmall	Eyes small/large
sVDSGPlate	VDSG Plate
sRemoteActivation	This object is activated from somewhere else.
sSkillLevelNovice	Novice
sButtonLocked	That button cannot be remapped
sRadioVolume	Radio
sRSMShapeOption32	Drawn/Pursed
sKBBack	Backspace
sRSMShapeOption33	Happy/Sad
sRSMCustom	Custom
sHolidayFirstPlanting	First Planting
sCanNotTrainAnymore	You have reached your training limit for your current level.
sNoWaitUnderWater	You cannot wait while under water.
sRSMShapeOption35	Deflated/Inflated
sShape	Shape
sXBRThumbX	the Right Stick Left / Right
sKBLControl	L-Ctrl
sDeviceJoystick	Joystick
sAlignGood	Good
sViewDistance	View Distance
sRSMShapeOption36	Large/Small
sSpecNameStealth	Stealth
sXBRThumbY	the Right Stick Up / Down
sRSMShapeOption37	Puckered/Retracted
sInventoryUse	Use
sHUDRads	Rads
sMagicRangeStrike	Strike
sHolidayNorthWindsPrayer	North Wind's Prayer
sRSMShapeOption38	Convex/Concave
sRSMShapeOption39	Tilt Up/Down
sHairColor0	Bleached
sSexMale	male
sWeaponTypeOneHandPistol	Pistol
sOpenedContainer	Opened the container with a key.
sCantEquipPowerArmor	Power armor training is required to equip this item.
sStatsGeneral	General
sRSMFace	Face
sHairColor1	Brown
sHolidaySouthWindsPrayer	South Wind's Prayer
sXBLThumbX	the Left Stick Left / Right
sNoWaitTrespass	You cannot wait while trespassing.
sRSMBlueAbbrev	B:
sHairColor2	Chocolate
sSneakDetected	[DETECTED]
sAccept	Accept
sXBLThumbY	the Left Stick Up / Down
sKBDecimal	Pad .
sNoFastTravelHostileActorsNear	You cannot fast travel when enemies are nearby.
sSaveNotAvailable	No valid save game found.
sHairColor3	Platinum
sForehead	Forehead
sEyes	Eyes
sHairColor4	Cornsilk
sJournalTitleActive	Active Quest
sInventoryDrop	Drop
sLevelProgress	Level Progress
sAutosaveAbbrev	AUTO
sHairColor5	Suede
sHair	Hair
sImpactParticleMetalDefault	Effects\ImpactBallisticMetal01.nif
sAnimationCanNotUnequip	You cannot change weapons while attacking.
sButton	Button
sHairColor6	Pecan
sActionPointsReload	Reload
sKBCalculator	Calc
sKBAdd	Pad +
sHairColor7	Auburn
sPS3DPadRight	D-Pad Right
sKBNext	PgDn
sHour	hour
sHairColor8	Ginger
sInventoryUnequip	Unequip
sName	Name
sOk	Ok
sUActnHotKey1	Hotkey 1
sConfirmLoad	Load this game?
sSaveOnRest	Save On Rest
sHairColor9	Honey
sTerminalServerText10	-Server 10-
sPS3LThumbLeft	the Left Stick Left
sUActnHotKey2	Hotkey 2
sKarmicTitleEvil01	Vault Delinquent
sUActnHotKey3	Hotkey 3
sNoFastTravelAlarm	You cannot fast travel while guards are pursuing you.
sContinue	Continue
sOn	ON
sActivateCreatureCalmed	The creature is calmed and cannot respond.
sKarmicTitleEvil02	Vault Outlaw
sUActnHotKey4	Hotkey 4
sKarmicTitleEvil03	Opportunist
sKBRShift	R-Shift
sUActnHotKey5	Hotkey 5
sFootstepsVolume	Footstep
sRSMPreset	Preset:
sBeardflushed	Beard flushed/pale
sKarmicTitleEvil04	Plunderer
sUActnHotKey6	Hotkey 6
sHackingHeader	ROBCO INDUSTRIES (TM) TERMLINK PROTOCOL
sMagicCastInsufficientMagicka	You don't have enough Magicka
sKarmicTitleEvil05	Fat Cat
sUActnHotKey7	Hotkey 7
sLoadingArea	
sCauterize	Cauterizing tool
sMagicCastMultipleBoundEffects	You already have that kind of Bound Item
sKarmicTitleEvil06	Marauder
sUActnHotKey8	Hotkey 8
sEnableHelp	Enable Help
sKarmicTitleEvil07	Pirate of the Wastes
sWeaponTypeTwoHandHandle	Handle Weapon
sJoyLeft	Left
sLockpickingTitle	LOCKPICKING
sGiveAway	Give away
sKarmicTitleEvil08	Reaver
sRSMRandomize	Randomize
sChinwide	Chin wide/thin
sCursorFilename	Interface\Icons\Misc\cursor.dds
sSexFemalePossessive	her
sKarmicTitleEvil09	Urban Invader
sStatsRadResist	RAD RESIST
sEyestogether	Eyes together/apart
sActorFade	Actor Fade
sMagicEffectItemDamage	Damage
sLostController	The Xbox 360 Controller has been disconnected. Click OK to use the Keyboard/Mouse, or reconnect the Xbox 360 Controller and press the A Button.
sMagicEffectItemIn	in
sKBLShift	L-Shift
sSteal	Steal
sDisableXBoxController	360 Controller
sNosebridgeshallow	Nose bridge shallow/deep
sRSMShapeOption40	Underbite/Overbite
sRSMFacialHair	Facial Hair
sForeheadtall	Forehead tall/short
sPS3RThumbDown	the Right Stick Down
sConfirmSave	Overwrite this game?
sRSMShapeOption41	Mouth-Chin Dist.
sLeftArmDamagedMessage	Your left arm is now crippled.
sMenuDisplayDayString	Day
sRSMShapeOption42	Bridge Depth
sBloodSplatterColor01OPTFilename	Textures\Gore\ScreenBloodColor01OPT.dds
sMouseRightButton	Mouse2
sSaveGameDeviceError	There was an error accessing the device.  Please try again.
sHeavyArmorSink	Your heavy armor is causing you to sink.
sRSMShapeOption43	Bridge Length
sSexMalePossessive	his
sSeasonFall	Fall
sHackingToleranceReset1	Allowance
sMonthMarch	March
sXBRThumb	\general_button_rs.dds\
sXBBackBtn	Back
sRSMShapeOption45	Flat/Pointed
sHackingToleranceReset2	replenished.
sVampireTalk	Talk
sDefaults	Defaults
sRSMShapeOption46	Nostril Tilt
sNPCModelBeast	Characters\_Male\SkeletonBeast.NIF
sStatsSpecial	S.P.E.C.I.A.L.
sRSMShapeOption47	Nostril Size
sInventoryCondition	CND
sKBComma	,
sPoisonNoWeaponMessage	You must first equip a weapon to poison it.
sRSMShapeOption48	Nostrils Wide/Thin
sVDSGManual	VDSG MANUAL
sLockpickSkillTooLow	You need a lockpick skill of %d to pick this lock.
sNosesellionlower	Nose sellion lower shallow/deep
sMouthtilt	Mouth tilt up/down
sKBDelete	Delete
sUActnRestmenu	Wait
sMenuDisplayXBoxSaveMessage	Saving content. Please don't turn off your console.
sStatsLVLAbbrev	LVL
sStatsStatus	Status
sPS3RThumbRight	the Right Stick Right
sFacethin	Face thin/wide
sMagicCastRangedUnderwater	You cannot cast ranged spells underwater
sNoWaitInJail	You must sleep in a jail bed in order to serve your sentence.
sStatsAddicted	ADDICT
sHolidayWarriorsFestival	Warrior's Festival
sXBLThumb	\general_button_ls.dds\
sMain	Main
sTargetTypeRead	Read
sKBStop	Stop
sKBNumpad0	Pad 0
sKBNumpad1	Pad 1
sNoItemsToRepair	No items to repair
sLockLevelNameHard	Hard
sKBNumpad2	Pad 2
sVideo	Video
sRightLegDamagedByPlayerIcon	Interface\Icons\Message Icons\glow_message_vaultboy_very_happy.dds
sKBNumpad3	Pad 3
sKarmicTitleEvil10	Ne'er-do-well
sKBNumpad4	Pad 4
sConfirmQuit	Are you sure you want to quit?
sKarmicTitleEvil11	Capitol Crimelord
sKBNumpad5	Pad 5
sHUDUseKey	Use Key
sBloodSplatterFlare01Filename	Textures\Effects\FXBloodFlare.dds
sKarmicTitleEvil12	Defiler
sKBNumpad6	Pad 6
sKBEsc	Esc
sNormal	Normal
sNoSleepHostileActorsNear	You cannot sleep when enemies are nearby.
sKarmicTitleEvil13	Vault Boogeyman
sTargetTypeSleep	Sleep
sWeaponTypeTwoHandMelee	Melee - Two Hand
sMouseButton3	Button 3
sKBNumpad7	Pad 7
sVatsSelect	Select
sRSMGreenAbbrev	G:
sDisableHelp	Disable Help
sKarmaMinorGained	You've gained Karma!
sFloraSuccessMessage	You successfully harvest %s.
sKarmicTitleEvil14	Harbinger of War
sMouseButton4	Button 4
sKBNumpad8	Pad 8
sHelp	Help
sInventoryDamageResistance	DR
sHackingCorrect	correct
sKarmicTitleEvil15	Urban Superstition
sMouseButton5	Button 5
sKBNumpad9	Pad 9
sLoadSavedGame	Load Saved Game
sCheekboneslow	Cheekbones low/high
sKarmicTitleEvil16	Villain of the Wastes
sMouseButton6	Button 6
sKBMyComputer	My Comp
sHeavyArmorNoJump	Your heavy armor prevents you from jumping.
sPipboyColor	Pip-Boy Color
sNone	None
sKarmicTitleEvil17	Fiend
sMouseButton7	Button 7
sCantSaveNow	You cannot save right now.
sMenuDisplayPlayTime	Play Time
sKarmicTitleEvil18	Wasteland Destroyer
sCrimeTypeTrespass	Trespass
sMouseButton8	Button 8
sKBRWin	RWin
sTune	Tune
sKarmicTitleEvil19	Evil Incarnate
sBlue	Blue
sTargetTypeUnequip	Unequip
sJoyUpRight	Up-Rt
sKBBackslash	\
sUActnQuickload	Quickload
sMerchantNoGold	Merchant doesn't have enough caps.
sSneakAttackCriticalStrikeIcon	Interface\Icons\Message Icons\glow_message_vaultboy_very_happy.dds
sNoSleepCombat	You cannot sleep while in combat.
sMagicTypePotion	Potion
sMonthJuly	July
sPickpocket	Pickpocket
sNoTalkUnConscious	is unconscious.
sSkillLevelApprentice	Apprentice
sChintall	Chin tall/short
sKarmicTitleGood01	Vault Guardian
sCrimeTypeMurder	Murder
sRadioSignalLost	%s signal lost.
sNoJumpWarning	You can not drop objects while in the air.
sRSMShapeOption50	Sellion Height
sKarmicTitleGood02	Vault Martyr
sKBVolumeDown	Vol -
sForceLock	Force Lock
sRSMShapeOption51	Sellion Depth
sBrowRidgeInner	Brow Ridge Inner up/down
sTakeAll	Take All
sKarmicTitleGood03	Sentinel
sKBNextTrack	Next
sNoWaitInCombat	You cannot wait while in combat.
sHackingWarning	!!! WARNING: LOCKOUT IMMINENT !!!
sKarmicTitleGood04	Defender
sRSMShapeOption53	Sellion Width
sKarmicTitleGood05	Dignitary
sNoLockPickIfCrimeAlert	You can't pick a lock while being pursued by guards.
sRSMShapeOption54	Short/Long
sEyesdark	Eyes dark brown/light blue
sKarmicTitleGood06	Peacekeeper
sStimpak	Stimpak
sRSMShapeOption55	Tilt Down/Up
sNosenostrilswide	Nose nostrils wide/thin
sMouthlipslarge	Mouth lips large/small
sKarmicTitleGood07	Ranger of the Wastes
sRSMEyeColor	Eye Color
sKarmicTitleGood08	Protector
sKarmicTitleGood09	Urban Avenger
sYesText	Yes
sHeadDamagedByPlayerIcon	Interface\Icons\Message Icons\glow_message_vaultboy_very_happy.dds
sSaveSuccessful	Save successful.
sTextureSize	Texture Size
sLow	Low
sXBXBtn	\general_button_x.dds\
sStatsRADAbbrev	RAD
sBloodSplatterAlpha01OPTFilename	Textures\Gore\ScreenBloodAlpha01OPT.dds
sDelete	Delete
sImpossibleLock	This lock cannot be picked. It requires a key to open.
sStatsAlcohol	Alcohol
sMainMenu	Main Menu
sMagicEffectItemDrain	Drain
sTargetTypeRecharge	Recharge
sUActnQuicksave	Quicksave
sMagnitudeIsLevelText	Target Level
sVatsAiming	Aiming
sValue	Value
sMagicEffectItemFortify	Fortify
sKBF1	F1
sKBMultiply	Pad *
sPick	Pick
sKBF2	F2
sPCMenuHintRMB	RMB)
sKBF3	F3
sCheekbonesshallow	Cheekbones shallow/pronounced
sKBWebBack	Web <-
sKBF4	F4
sSurgery	Surgery
sStatsCNDAbbrev	CND
sSkillsTitle	SKILLS:  %d/%d Selected
sPS3L1	\general_button_lb.dds\
sKBF5	F5
sExplosionSplashParticles	Effects\ExplosionSplash.NIF
sPS3L2	\general_button_lt.dds\
sXBDPadX	D-Pad Left / Right
sKBF6	F6
sPressStart	Press [START]
sAMTime	AM
sEyesocketsbruised	Eye sockets bruised/bright
sKarmicTitleEvil20	Scourge of Humanity
sPS3L3	\general_button_ls.dds\
sXBDPadY	D-Pad Up / Down
sKBF7	F7
sHolidayMerchantsFestival	Merchant's Festival
sKBApps	Apps
sKBF8	F8
sKBF9	F9
sRewardXP	Experience Points Earned
sInventoryRepair	Repair
sInventoryDamage	DAM
sPS3DPadLeft	D-Pad Left
sChemsWornOff	%s has worn off.
sTargetTypeVampire	Feed/Talk
sKBPeriod	.
sKB0	0
sKB1	1
sKB2	2
sPlayTime	Play Time
sSexMalePronoun	he
sActionPointsThrow	Throw
sKB3	3
sEyesTex	Eye shades
sKB4	4
sCheekblush	Cheek blush light/red
sKB5	5
sRewardXPIcon	Interface\Shared\Messages\glow_XP_Gain.dds
sNoDeviceSelected	You have not selected a storage device.  You will need to select one before you can save.  Until then, Autosave is disabled.
sActionPointsCrouch	Crouch
sKB6	6
sKeyLocked	That key cannot be remapped
sQuestsTabText	Quests
sMagicSchoolAlteration	Alteration
sKB7	7
sStealHorse	Do you want to steal this horse?
sArmorWeightLight	Light
sKB8	8
sStatsRadiation	Radiation
sMouthhigh	Mouth high/low
sHackingIntro01	WELCOME TO ROBCO INDUSTRIES (TM) TERMLINK
sKarmicTitleGood10	Exemplar
sKBOEM102	<
sKB9	9
sBrowRidgeOuter	Brow Ridge Outer up/down
sInventoryEffects	EFFECTS
sKarmaMinorGainedImage	Interface\Icons\PipboyImages_small\Karma icons\glow_karma_good.dds
sHackingIntro02	SET TERMINAL/INQUIRE
sKarmicTitleGood11	Capitol Crusader
sCantEquipGeneric	You cannot equip this item.
sStatsBody	Body
sStatsPerks	Perks
sComplexion	Complexion
sWeight	Weight
sHackingHeader2	ENTER PASSWORD NOW
sHackingIntro03	RIT-V300
sLarge	Large
sKarmicTitleGood12	Paladin
sHackingHeader3	ATTEMPT(S) LEFT:
sHackingIntro04	SET FILE/PROTECTION=OWNER:RWED ACCOUNTS.F
sKarmicTitleGood13	Vault Legend
sPoisonAlreadyPoisonedMessage	The current weapon is already poisoned.
sCheeksconcave	Cheeks concave/convex
sMapMarkerAdded	Map marker added.
sHackingIntro05	SET HALT RESTART/MAINT
sKarmicTitleGood14	Ambassador of Peace
sMenuDisplaySave	Save
sRSMHairColor	Hair Color
sHackingIntro06	Initializing Robco Industries(TM) MF Boot Agent v2.3.0
sKarmicTitleGood15	Urban Legend
sRightArmDamagedByPlayerIcon	Interface\Icons\Message Icons\glow_message_vaultboy_very_happy.dds
sLeftArmDamagedIcon	TypeIcons\hot_keys_icon_unarmedweapons.dds
sHackingIntro07	RETROS BIOS
sKarmicTitleGood16	Hero of the Wastes
sYesRestart	Yes, restart the game.
sConfirmNew	Start a new game?
sHackingIntro08	RBIOS-4.02.08.00 52EE5.E7.E8
sKarmicTitleGood17	Paragon
sHackingIntro09	Copyright 2201-2203 Robco Ind.
sKarmicTitleGood18	Wasteland Savior
sLockLevelNameVeryHard	Very Hard
sMagicTypeAddiction	Addiction
sKarmicTitleGood19	Saint
sSaveGameIsCorrupt	The save game is corrupt.  Returning to game.
sMagicTypePower	Power
sSkillLevelJourneyman	Journeyman
sEyebrowslow	Eyebrows low/high
sGreen	Green
sEyeswhites	Eyes whites dim/bright
sFace	Face
sMonthJune	June
sXBDPadRight	D-Pad Right
sNoSitOnOwnedFurniture	You cannot sit on owned furniture.
sSelect	Select
sDefaultCellName	Wilderness
sJoyUp	Up
sNoFastTravelScriptBlock	Fast travel is currently unavaliable from this location.
sKarmaMajorGainedImage	Interface\Icons\PipboyImages_small\Karma icons\glow_karma_saintly.dds
sSpecNameCombat	Combat
sConfirmContinue	Continue from your last saved game?
sBeardmoustache	Beard moustache light/dark
sTraitsCount	Choose up to %d Trait
sMagnitudeText	Magnitude
sLipstickdarkblue	Lipstick dark blue/light red
sStyle	Style
sFemale	Female
sComputersWelcome	Welcome to the service on SERVER1
sEquipItemOnPlayer	was equipped
sTargetTypeEquip	Equip
sUActnUse	Attack
sLoadingContentMessage	Loading extra content. Please wait.
sMenuDisplayShortXBoxSaveMessage	Saving...
sAlignVeryEvil	Very Evil
sCameraPitch	Invert Y
sNoWaitInRadiation	You cannot wait while being irradiated.
sAttributesCount	Distribute %d Point
sMagicProjectileTypeSpray	Spray
sMagicTypeLevelled	Leveled Actor Effect
sIgnoreText	Ignore
sDurationText	Duration
sAutoLoading	Autoloading...
sStatsXP	XP
sAudio	Audio
sKBNumPadComma	Pad ,
sHolidayTalesAndTallows	Tales and Tallows
sDaySaturday	Saturday
sKBF10	F10
sSkintintorange	Skin tint orange/blue
sNosesellionthin	Nose sellion thin/wide
sBloodTextureDefault	Effects\blooddecal.dds
sKBF11	F11
sLoadingLOD	Loading distant LOD...
sCantRepairPastMax	CANNOT REPAIR PAST %.0f%s
sNosetilt	Nose tilt down/up
sKBF12	F12
sTextNote	Text File
sKBF13	F13
sKarmaMajorLostImage	Interface\Icons\PipboyImages_small\Karma icons\glow_karma_evil.dds
sOfferRefused	Offer refused
sKBF14	F14
sTargetTypeDrink	Drink
sKBF15	F15
sVatsTarget	Target
sSkinflushed	Skin flushed/pale
sKBMail	Mail
sSaveGame	Save Game
sMonthNovember	November
sKBMediaStop	Stop
sKBReturn	Enter
sQuickSaving	Quicksaving...
sAlignEvil	Evil
sSaveOnTravel	Save On Travel
sKBWebStop	Web Stop
sBrightness	Brightness
sWait	wait
sRSMSex	Sex
sTargetTypeTake	Take
sPlayer	player
sInaccessible	[INACCESSIBLE]
sJoyUpLeft	Up-Left
sHackingIntro10	Uppermem: 64 KB
sKBLeft	Left
sUActnRun	Run
sEyestilt	Eyes tilt inward/outward
sHackingIntro11	Root (5A8)
sKarmicTitleGood20	Last, Best Hope of Humanity
sHeadDamagedMessage	Your head is now damaged.
sHackingIntro12	Maintenance Mode
sSplashParticles	Effects\waterSplash.NIF
sLevelUpSkillCounterPl	ASSIGN %d SKILL POINTS
sHackingIntro13	RUN DEBUG/ACCOUNTS.F
sAttributeDamaged	has been damaged
sAutoSaveDisabledDueToLackOfSpace	Save location full. Disabling Autosave.
sEyebrows	Eyebrows
sSneakCaution	[CAUTION]
